0 0 0 0 0 0 0 0 0 0 0 0 0 0 0 0 0 0 0 0 0 0 0 0 0 0 0 0 0 0
6 0 0 0 0 0 0 0 0 0 0 0 0 0 0 0 0 0 0 0 0 0 0 0 0 0 0 0 0 13
6 1 1 1 0 1 1 16 16 16 1 1 0 0 0 0 0 0 0 0 0 0 0 0 0 0 0 0 0 12
6 0 0 0 0 0 1 1 1 1 1 1 1 1 0 0 0 0 0 0 0 0 1 1 1 0 1 1 1 1
6 0 0 0 0 0 0 0 0 0 0 0 0 0 0 0 1 1 1 1 0 0 0 0 0 0 0 0 0 0
1 1 0 0 0 0 0 0 0 0 0 0 0 0 0 0 0 0 0 0 0 0 0 0 0 0 0 0 0 0
0 0 0 0 1 1 1 0 0 1 1 1 1 0 0 0 0 0 0 0 0 0 0 0 0 1 0 0 0 0
0 0 0 0 0 0 0 0 0 0 0 0 1 1 17 17 1 1 0 0 0 0 0 0 0 1 1 0 6 0
0 0 0 0 0 0 0 0 0 0 0 0 0 0 0 0 1 1 0 1 1 0 1 0 0 1 1 1 6 0
0 0 0 0 0 0 0 0 0 0 0 0 0 0 0 0 0 0 0 0 0 0 0 0 0 0 0 0 6 0
0 0 0 0 0 0 0 0 0 6 0 0 0 0 0 0 0 0 0 0 0 0 0 0 0 0 0 0 6 0
0 0 0 0 0 0 0 0 0 6 1 1 1 0 0 0 0 0 0 0 0 0 0 0 0 0 0 0 6 0
0 0 0 0 0 0 0 0 0 6 0 0 0 0 0 0 0 0 0 0 0 0 0 0 0 0 0 2 2 2
0 0 0 0 0 7 0 0 0 6 0 0 7 0 0 0 0 0 0 0 0 0 0 2 0 0 0 3 3 3
0 0 0 0 0 8 0 0 0 6 0 0 8 0 0 0 0 0 0 0 0 0 2 3 0 0 0 3 3 3
0 0 0 14 0 9 0 0 0 6 0 0 9 0 0 0 0 2 2 0 0 2 3 3 0 0 0 3 3 3
2 2 2 2 2 2 2 2 2 2 2 2 2 5 5 5 5 3 3 5 5 3 3 3 5 5 5 3 3 3
3 3 3 3 3 3 3 3 3 3 3 3 3 4 4 4 4 3 3 4 4 3 3 3 4 4 4 3 3 3
3 3 3 3 3 3 3 3 3 3 3 3 3 4 4 4 4 3 3 4 4 3 3 3 4 4 4 3 3 3
1 1 1 1 1 1 1 1 1 1 1 1 1 1 1 1 1 1 1 1 1 1 1 1 1 1 1 1 1 1