0 0 0 0 0 0 0 0 0 0 0 0 0 0 0 0 0 0 0 0 0 0 0 0 0 0 0 0 0 0
0 0 0 0 0 0 0 0 0 0 0 0 0 0 0 0 0 0 0 0 0 0 0 0 0 0 0 0 0 13
0 0 0 6 0 0 14 0 0 14 14 0 0 0 0 0 0 0 0 0 0 0 0 0 0 0 0 0 0 12
0 0 1 6 1 1 1 0 1 1 1 1 0 0 0 0 0 0 0 0 0 0 0 0 0 0 0 0 0 1
0 0 0 6 0 0 0 0 0 0 0 0 0 0 0 0 0 0 0 14 0 0 0 0 14 0 0 0 1 1
0 0 0 6 0 0 0 0 0 0 0 0 0 0 6 0 0 1 1 1 17 17 17 17 1 1 16 16 1 1
0 0 0 6 0 0 0 0 0 0 0 0 14 0 6 1 1 1 1 1 0 0 0 0 1 1 1 1 1 1
0 0 1 6 1 1 0 0 1 17 17 17 1 1 6 0 0 0 0 0 0 0 0 0 0 0 0 0 0 0
0 0 0 6 0 0 0 0 0 0 0 0 0 0 6 0 0 0 0 0 0 0 0 0 0 0 0 0 0 0
0 0 0 6 0 0 14 14 0 0 0 0 0 0 6 0 0 0 0 0 0 0 0 0 0 0 0 0 0 0
0 0 0 6 0 0 1 1 0 0 0 0 0 0 1 1 16 16 1 0 0 0 0 14 0 0 6 0 0 0
0 0 0 6 0 0 0 0 0 0 0 0 0 0 1 1 1 1 1 1 0 0 0 1 1 1 6 0 0 0
0 0 0 6 0 0 0 0 0 0 0 0 0 0 0 0 0 0 0 0 0 0 1 0 0 0 6 0 0 0
0 0 0 1 0 0 0 0 0 0 0 0 0 0 0 0 0 0 0 0 0 0 0 0 0 0 6 0 0 0
11 0 0 1 1 0 0 1 16 16 1 0 14 0 6 0 1 1 0 0 0 0 0 0 0 0 6 0 0 0
10 0 0 0 0 0 0 1 1 1 1 1 1 1 6 1 1 1 0 0 1 1 1 17 17 17 1 0 0 0
1 0 0 0 0 0 0 0 0 0 0 0 0 0 6 0 0 0 0 0 0 0 0 0 0 0 0 0 0 0
1 0 0 0 0 0 0 0 0 0 0 0 0 0 6 0 0 0 0 0 0 0 0 0 0 0 0 0 0 0
1 0 0 0 0 14 14 0 0 0 0 0 0 0 6 0 0 0 0 0 0 0 0 0 0 0 0 0 0 0
1 1 16 1 1 1 1 1 1 1 1 16 16 1 1 1 16 16 16 16 16 16 16 16 16 16 16 16 16 16