0 0 0 0 0 0 0 0 0 0 0 0 0 0 0 0 0 0 0 0 0 0 0 0 0 0 0 0 0 0
0 0 0 0 0 0 0 0 0 0 0 0 0 0 0 0 0 0 0 0 0 0 0 0 0 0 0 0 0 13
0 0 0 0 0 0 0 0 0 0 0 0 0 0 0 6 0 0 0 0 0 0 0 0 0 21 0 0 0 12
0 0 0 0 0 0 0 0 0 0 0 0 0 0 0 6 21 0 0 0 22 0 0 0 0 0 0 0 0 19
0 0 0 0 0 0 0 19 16 19 0 0 0 0 0 6 0 0 0 21 21 21 0 0 0 0 0 0 21 21
6 0 0 19 0 0 0 21 21 21 0 0 0 0 0 6 0 0 0 0 0 0 0 0 0 0 0 0 0 0
6 0 21 21 0 0 0 0 0 0 0 0 0 0 0 21 0 0 0 0 0 0 0 0 0 0 0 0 0 0
6 0 0 0 0 0 0 0 0 0 0 0 0 0 0 0 0 0 0 0 0 0 0 0 0 0 0 0 0 6
6 0 0 0 0 0 0 0 0 0 0 0 0 0 0 0 0 0 0 0 0 0 0 0 19 0 0 19 0 6
6 0 0 0 0 0 0 0 22 0 0 0 0 0 0 0 0 0 0 22 19 16 16 16 21 0 0 0 0 6
6 0 0 0 0 0 0 0 21 16 21 0 0 0 0 21 0 0 0 21 21 21 21 21 21 0 0 0 0 6
19 0 0 0 0 22 0 0 21 21 21 0 0 0 0 0 0 0 0 0 0 0 0 0 0 0 0 0 0 6
21 0 0 0 21 21 21 0 0 0 0 0 0 0 0 0 0 0 0 0 0 0 0 0 0 0 0 22 0 6
0 0 0 0 0 0 0 0 0 0 0 0 0 0 0 0 0 0 0 0 0 0 0 0 19 0 0 22 0 6
11 0 0 0 0 0 0 0 0 0 0 0 0 0 0 0 0 0 0 0 0 0 0 0 0 0 0 22 0 6
10 0 0 0 0 0 0 0 0 22 0 0 0 0 0 19 0 0 0 0 0 0 0 0 0 0 19 19 0 6
19 19 0 0 0 0 0 0 19 19 19 19 0 0 0 21 0 0 0 0 0 0 0 0 0 19 0 0 0 6
21 21 0 19 0 0 0 0 21 21 21 21 16 16 16 21 0 0 0 0 0 0 0 19 0 0 0 0 0 6
21 21 16 21 22 22 22 22 21 21 21 21 15 15 15 21 22 22 22 22 21 16 16 16 16 16 16 16 16 20 20
20 20 20 20 20 20 20 20 20 20 20 20 20 20 20 20 20 20 20 20 20 20 20 20 20 20 20 20 20 20 20