0 0 0 0 0 0 0 0 0 0 0 0 0 0 0 0 0 0 0 0 0 0 0 0 0 0 0 0 0 0
0 0 0 0 0 0 0 0 0 0 0 0 0 0 0 0 0 0 0 0 0 0 0 0 0 0 0 0 0 13
27 27 27 27 0 0 0 0 0 0 0 0 0 0 0 0 0 0 0 0 0 0 0 0 0 25 0 0 0 12
26 26 26 0 0 0 0 0 0 0 0 0 0 0 0 0 27 5 5 27 0 0 27 27 27 27 27 27 27 27
0 0 0 0 0 0 0 0 0 0 0 27 27 27 0 0 27 27 27 27 0 0 0 0 0 0 0 0 0 0
0 0 0 0 0 0 27 27 27 0 0 0 0 0 0 0 26 0 0 0 0 0 0 0 0 0 0 0 0 0
27 27 27 0 0 0 0 0 0 0 0 0 0 0 0 0 0 0 0 0 0 0 0 0 0 0 0 0 0 6
0 0 0 27 27 6 0 0 0 0 0 0 0 0 0 0 0 0 0 0 0 0 0 27 27 27 27 27 0 6
0 0 0 0 0 6 0 0 0 0 0 0 0 0 0 0 0 0 27 0 27 0 0 0 0 0 0 0 0 6
0 0 0 0 0 27 27 27 27 27 27 0 0 0 0 27 0 0 0 0 26 0 0 0 0 0 0 0 0 6
0 0 0 0 0 0 0 0 0 0 0 0 0 0 0 0 0 0 0 0 0 0 0 0 0 0 0 0 0 6
0 0 0 0 0 0 0 0 0 0 0 0 0 0 0 0 0 0 0 0 0 0 0 0 0 0 0 0 0 6
0 0 0 0 0 0 0 0 0 0 0 0 0 0 0 0 0 0 0 27 27 27 27 27 27 27 27 0 0 27
0 0 0 0 0 0 0 0 0 0 0 0 0 0 0 0 0 0 0 0 0 0 0 0 0 0 0 0 0 0
11 0 0 0 0 0 0 0 0 0 0 0 0 23 23 23 23 0 0 0 0 0 0 0 0 0 0 0 0 0
10 0 0 0 0 0 0 0 0 0 0 0 23 24 24 24 24 23 0 0 0 0 0 0 0 0 0 0 0 0
23 23 23 23 0 0 0 0 0 0 23 23 24 24 24 24 24 24 23 23 5 5 5 5 5 5 5 5 5 5
24 24 24 24 24 0 0 0 0 24 24 24 24 24 24 24 24 24 24 24 4 4 4 4 4 4 4 4 4 4
24 24 24 24 24 25 25 25 25 24 24 24 24 24 24 24 24 24 24 24 24 24 24 24 24 24 24 24 24 24
24 24 24 24 24 24 24 24 24 24 24 24 24 24 24 24 24 24 24 24 24 24 24 24 24 24 24 24 24 24